SO ./textures/south.xpm

NO ./textures/north.xpm

WE ./textures/west.xpm


EA ./textures/east.xpm

F  225,255,0                       
C 225,255,0


1111111111111111111111
1000000100001000000001
1000001W10000000000001
1000000100000000000001
1000000000000100000001
1111111111111111111111
