SO ./textures/south.xpm

NO ./textures/north.xpm

WE ./textures/west.xpm


EA ./textures/east.xpm

F   225,255,0
C 225,255,0

11111
10001
10001
10001
10W01
11111
