 
EA ./textures/east.xpm
WE ./textures/west.xpm
NO ./textures/north.xpm
F 225,255,0
C     225,255,0

adfdd

1111111
1000N11
1111111





