SO ./textures/south.xpm

NO        ./textures/north.xpm

WE		          ./textures/west.xpm


EA			./textures/east.xpm

F   1,1,5
C 225,255,0

11111
10001
10001
10001
10001
100S1
10001
1111
