SO  ./textures/south.xpm

EA  ./textures/east.xpm

WE  ./textures/west.xpm

NO  ./textures/north.xpm

F   225,255,0
C 225,255,0

1111111111111111111 1
       111N00000000101
1111111000000011111 1
10000000000001
1000000000001
100000000001
11111111111


       



