SO  ./textures/south.xpm

EA  ./textures/east.xpm

WE  ./textures/west.xpm

NO  ./textures/north.xpm

F   225,255,0
C 225,255,0

111111111
111111111
    
























