SO  ./textures/south.xpm

EA  ./textures/east.xpm

WE  ./textures/west.xpm

NO  ./textures/north.xpm

F   225,,0
C 225,255,0

  1111111111111111111111
  111111 1011001000000101
 11111101000001111111111
1111111111111111111111
1                    1
1                    1
1                    1
1                    1
1111111111111111111111
 1000001 11110001
 100W00010000111
 100000000001
111111111111
1
1
1      
11
101
111


