SO  ./textures/south.xpm

EA  ./textures/east.xpm

WE  ./textures/west.xpm

NO  ./textures/north.xpm

F   225,255,0
C 225,255,0


   


   
                 
111111111111111        
11111N000000001
100000000000001 W
100000000000001
100000000000001
100000000000001
111111111111111
11111111      11

       



